1000
18 24
########################
#                      #
# #########  ######### #
# #CCCCPCC#  #CCPCCCC# #
# #########  ######### #
#      #        #      #
###    #        #    ###
#C####################C#
#r        #$$#        R#
#PPPPP#$#PPPPPP#$#PPPPP#
########################
#C                    C#
#P        #CC#        P#
#C      ########      C#
#P    #C#      #C#    P#
#C    ### #  # ###    C#
#C        #$$#        C#
########################