1000
18 18
##################
#                #
#  r             #
# R############  #
#  #C C C C# P#$ #
#  # C C C # C## #
#  #C C C C# ##  #
#  # C C C # #   #
#  #C C C  # # # #
#  # C C  $# # # #
#  #C C  $##   # #
#  #########  $# #
#  #          ## #
#  #PC####     #C#
#  ####    $#  ###
#   $#  ##########
#            C####
##################