1000
18 24
########################
#                      #
#  ### ###    ### ###  #
#  #   #      # # #    #
#  #   ###    ### ###  #
#  #     #      #   #  #
#  ### ###    ### ###  #
#                      #
########################
#C         PCP        C#
# #################### #
# #P$#CP#C$P#C  C#$#$# #
# #r##C$# # #$## #C#P# #
# #R##C$# # #$## #C#P# #
# #P$#CP#C$P#C  C#$#$# #
# #################### #
#C         PCP        C#
########################
