1000
18 24
########################
#                      #
#                      #
#  R  C  C    C  C  R  #
#                      #
#   ###### CC ######   #
#        #    #        #
#        #    #        #
#        # PP #        #
#        #    #        #
#        #    #        #
#####    # CC #    #####
#        #    #        #
# ###    ######    ### #
#CCC####  #$$#  ####CCC#
#CCCPCC##      ##CCPCCC#
#CCCPPCC# #$$# #CCPPCCC#
########################