1000
18 25
#########################
#r$#C C  C  C#C C C C C #
# ## ##################C#
# P#C#CCC          CCC# #
# P# #CCC####$#####CCC#C#
#  #C#####        ##### #
#  # #                #C#
#  #C#### # ##### ##### #
# C# #CCC # CPCP# CCCC#C#
# C# #CCC # CPCP# CCCC#C#
#  #C#### # ##### ##### #
#  # #                #C#
#  #C#####        ##### #
# P# #CCC####$#####CCC#C#
# P#C#CCC          CCC# #
# ## ##################C#
#R$#C C  C  C#C C C C C #
#########################